#map: def

map:
AAAAAAAAAAAAAAA
A             A
A             A
A             A
A             A
A             A
A      @      A
A             A
A             A
A             A
A             A
A             A
A             A
AAAAAAAAAAAAAAA